999999999999999999999999999999999999999
900000000000000000000000000001199911009
900208000000000000000200000000119110009
911211001100110011111211110000001100089
900200000000000001110200011111000000119
900200000000000000000200000011111111119
900200000000000000000200000000011111009
900111000000000000000200000000000000009
900000011000000001111111100080000000029
900000000011020110000000000111111111129
900000000000021000000000000000000000029
900000000000020000000000000000000000029
900000000000020000110020080011000000029
900001110000020000000021111111000000029
910000000080020000000020000000000110029
900200000001110000000020000000000000029
900211111000000000000020000000000000029
900200000000000000000020000000000000029
900200000888888880000020000800000000029
999999999999999999999999999999999999999